0000000000000000000000000000000000000000000000000000
0110000001110111000011101110000000000000000000000000
0101011101010010000010101000000000000000000000000000
0110010101010010111011101110000000000000000000000000
0101010101010010000000101010000000000000000000000000
0101011101110010000011101110000000000000000000000000
0000000000000000000000000000000000000000000000000000